50 730 20 20
1800 690 50 80

0    770    1800 30     100 100 100 1
0    0      1800 30     100 100 100 1
0    0      30   770    100 100 100 1
1770 0      30   670    100 100 100 1

300  550    100  20     200 200 200 1

450  300    20   150    200 200 200 1

220  350    130  20     200 200 200 1

200  300    20   70     200 200 200 1

500  300    20   230    200 200 200 1
500  530    310  20     200 200 200 1
600  300    20   150    200 200 200 1
620  430    150  20     200 200 200 1

770  30     20   420    200 200 200 1
790  550    20   220    200 200 200 1

1020 450    70   20     200 200 200 1
1070 350    20   100    200 200 200 1
1090 350    100  20     200 200 200 1

790  200    70   20     200 200 200 1

1350 350    100  20     200 200 200 1
1670 350    20   420    200 200 200 1

1260 470    20   80     50  50  50  0
1260 570    20   200    200 200 200 1

1150 450    240  20     200 200 200 1
1190 550    160  20     200 200 200 1

