50 750 10 10
1800 300 50 100

0    770 1800 30  100 100 100 1
0    0   1800 30  100 100 100 1
0    0   30   770 100 100 100 1
1770 0   30   770 100 100 100 1

155  700 10   70  200 200 200 1
355  650 10   120 200 200 200 1
450  730 50   10  200 200 200 1
585  600 10   170 200 200 200 1
95   560 590  10  200 200 200 1
635  650 50   10  200 200 200 1
655  660 10   80 200 200 200 1

230  400 50   10  200 200 200 1
250  410 10   150 200 200 200 1
380  450 50   10  200 200 200 1
400  460 10   100 200 200 200 1
550  510 10   50  200 200 200 1
30   500 65   10  200 200 200 1
95   425 65   10  200 200 200 1

30   350 130  10  200 200 200 1
150  300 10   50  200 200 200 1
150  60  10   180 200 200 200 1
90   240 130  10  200 200 200 1
90   60  70   10  200 200 200 1
30   150 60   10  200 200 200 1

200  100 50   10  200 200 200 1
250  30  10   40  200 200 200 1
350  240 50   10  200 200 200 1
550  200 10   250 200 200 200 1
510  190 70   10  200 200 200 1
570  100 10   90  200 200 200 1
530  30  10   130 200 200 200 1
615  190 100  10  200 200 200 1
615  160 10   30  200 200 200 1
560  400 155  10  200 200 200 1

715  30  10   340 200 200 200 1
715  400 10   370 200 200 200 1


