50 730 25 25
1800 150 50 100

0    770    1800 30     100 100 100 1
0    0      1800 30     100 100 100 1
0    0      30   770    100 100 100 1
1770 0      30   150    100 100 100 1
1770 250    30   520    100 100 100 1


550  200    30   570    200 200 200 1
30   500    410  25     200 200 200 1
150  200    410  25     200 200 200 1

690   500   125  25     200 200 200 1
1100  400   200  25     200 200 200 1
1100  425   25   345    200 200 200 1
1300  150   25   275    200 200 200 1
1185  30    25   300    200 200 200 1

1500  550   25   220    200 200 200 1
1450  525   125  25     200 200 200 1
1650  250   120  25     200 200 200 1

1375  550   25   220    200 200 200 1
1325  525   125  25     200 200 200 1