50 720 25 25
1800 300 50 100

0    770    1800 30     100 100 100 1
0    0      1800 30     100 100 100 1
0    0      30   770    100 100 100 1
1770 0      30   300    100 100 100 1
1770 400    30   370    100 100 100 1

500  500    25   270    200 200 200 1
900  500    25   270    200 200 200 1
850  475    125  25     200 200 200 1
1300 300    25   200    200 200 200 1
1300 500    25   270    25  25  25  0
1250 275    125  25     200 200 200 1
1600 400    170  25     200 200 200 1