50 730 20 20
1800 370 50 80

0    770    1800 30     100 100 100 1
0    0      1800 30     100 100 100 1
0    0      30   770    100 100 100 1
1770 0      30   370    100 100 100 1
1770 450    30   320    100 100 100 1

340  500    100  20     200 200 200 1
380  500    20   170    200 200 200 1
380  670    20   100    50  50  50  0
420  240    20   270    200 200 200 1

260  30     20   230    200 200 200 1

340  240    100  20     200 200 200 1

420  30     20   70     200 200 200 1
410  100    40   20     200 200 200 1
590  240    30   20     200 200 200 1

780  150    20   620    200 200 200 1

900  30     20   400    200 200 200 1
900  510    20   260    200 200 200 1

920  510    60   20     200 200 200 1

1000 270    180  20     200 200 200 1
1000 290    20   140    200 200 200 1
1160 290    20   400    200 200 200 1
1160 690    20   80     50  50  50  0

1370 450    80   20     200 200 200 1
1400 470    20   60     50  50  50  0
1400 530    20   240    200 200 200 1

1690 450    80   20     200 200 200 1