50 750 10 10

0    770 1800 800 100 100 100 1
0    0   30   770 100 100 100 1
1770 0   1800 770 100 100 100 1
150  700 165  770 100 100 100 1
350  650 365  770 100 100 100 1
450  730 500  740 100 100 100 1
585  600 600  770 100 100 100 1
585  560 700  570 100 100 100 1