50 730 25 25
1800 670 50 100

0    770    1800 30     100 100 100 1
0    0      1800 30     100 100 100 1
0    0      30   770    100 100 100 1
1770 0      30   670    100 100 100 1

550  300    25   470    200 200 200 1
30   550    220  25     200 200 200 1
350  300    200  25     200 200 200 1

925  475    25   295    200 200 200 1

1300 475    25   295    200 200 200 1
1250 450    125  25     200 200 200 1

1600 200    25   570    200 200 200 1