50 730 20 20
1800 370 50 80

0    770    1800 30     100 100 100 1
0    0      1800 30     100 100 100 1
0    0      30   770    100 100 100 1
1770 0      30   370    100 100 100 1
1770 450    30   320    100 100 100 1