50 730 20 20
1690 800 40 80

0    770    1690 30     100 100 100 1
0    0      1800 30     100 100 100 1
0    0      30   770    100 100 100 1
1770 0      30   800    100 100 100 1

230  550    20   100    200 200 200 1
150  550    20   100	200 200 200 1
30   550    120  20     200 200 200 1

250  550    120  20     200 200 200 1
370  550    20   220    200 200 200 1

740  500    40   20     200 200 200 1
780  200    20   570    200 200 200 1
740  200    40   20     200 200 200 1

540  350    40   20     200 200 200 1
520  30     20   340    200 200 200 1
540  30     40   20     200 200 200 1

850  30     20   410    200 200 200 1
850  500    20   270    200 200 200 1

870  500    150  20     200 200 200 1
930  300    170  20     200 200 200 1
1080 300    20   410    200 200 200 1

930  100    220  20     200 200 200 1
1150 100    20   670    200 200 200 1

1170 500    80   20     200 200 200 1
1250 300    120  20     200 200 200 1
1380 500    80   20     200 200 200 1
1470 300    120  20     200 200 200 1
1590 500    80   20     200 200 200 1

1670 100    20   670    200 200 200 1