50 750 10 10

0    770 1800 800 100 100 100 1
0    0   1800 30  100 100 100 1
0    0   30   770 100 100 100 1
1770 0   1800 770 100 100 100 1

155  700 165  770 200 200 200 1
355  650 365  770 200 200 200 1
450  730 500  740 200 200 200 1
585  600 595  770 200 200 200 1
95   560 685  570 200 200 200 1
635  650 685  660 200 200 200 1
655  660 665  740 200 200 200 1
715  30  725  770 200 200 200 1

230  400 280  410 200 200 200 1
250  410 260  560 200 200 200 1
380  450 430  460 200 200 200 1
400  460 410  560 200 200 200 1
550  510 560  560 200 200 200 1
30   500 95   510 200 200 200 1
95   425 160  435 200 200 200 1

30   350 160  360 200 200 200 1
150  300 160  350 200 200 200 1
150  60  160  240 200 200 200 1
90   240 220  250 200 200 200 1
90   60  160  70  200 200 200 1
30   150 90   160 200 200 200 1

200  100 250  110 200 200 200 1

